################################
#                              #
#                              #
#       o   A #                #
###  o@   $                    #
#                  ##          #
#          ##                  #
#                              #
################################