######################
#A    $              #
#                    #
#     o @            #
#         #### @ o   #
#  o@                #
#                    #
######################              
